#########
#   @   #
#       #
#  ##.  #
#   #   #
#  &##. #
#  &    #
#       #
#########

#################
#####   #########
#####&  #########
#####  &#########
###  &  & #######
### # ### #######
#   # ### ##  ..#
# &  &      @ ..#
##### #### #  ..#
#####      ######
#################

##############
#     ###   @#
# ### ### ## #
# ##  * * ## #
#&##     ##  #
#.##### ### ##
###### * *  ##
###### #  # ##
######      ##
##############
##############
##############

###############################################
###############################################
#######################.######### #############
#######################&######### #############
####################### ######### #############
####################### ######### #############
####################### ######### #############
####################### ###  #### ###  ########
#######################      ####      ########
###########################* ########* ########
##########################  ########  #########
########################## ######### ##########
########################## #########          #
########################## ################## #
########################## ################## #
########################## ###      ##      # #
########################## ### #  # ##  # # # #
#####################      ###  * * ## * *  # #
##################### #### #### ## #### ## ## #
##################### ####      ## #### ## ## #
##################### ############ #### #     #
##################### ####      ## #### # #####
##################### #### #### ## #### # #####
##################### #  # ### * *  * *  * ####
#####################    # ### #   #   # # ####
#######################* # ###    ## #   # ####
######################  ##   ####    ##### ####
###################### ##### ############# ####
###################### ####         #      ####
###################### #### ####### # #########
####################        ####### *    ######
###########        # ######*########     ######
################## *  #####  ##################
###################   ###### ##################
############################ ##  ##############
############################     ##############
###############################* ##############
##############################  ###############
##############################@################
###############################################
