#########
#   @   #
#       #
#  ##.  #
#   #   #
#  &##. #
#  &    #
#       #
#########

#################
#####   #########
#####&  #########
#####  &#########
###  &  & #######
### # ### #######
#   # ### ##  ..#
# &  &      @ ..#
##### #### #  ..#
#####      ######
#################

##############
#     ###   @#
# ### ### ## #
# ##  * * ## #
#&##     ##  #
#.##### ### ##
###### * *  ##
###### #  # ##
######      ##
##############
##############
##############

######################################################
################################# ####################
################################# ####################
################################# ####################
################################  *  #################
################################   # #################
#################################### #################
####################################     #############
####################################  ## #############
##################################### ## ##    #######
#########################          ## ##    ## #######
######################### ########*   #####*   #######
######################### ######   ########    #######
######################    ###### #         *## #######
###################### #########  *########    #######
#####################  *  ######   ###################
#####################   # ####     ###################
######################### #### ###*########    #######
######################### #### ##          *## #######
######################### ####    *########    #######
######################### ####     ########*   #######
######################### ####  ##*   ##    ## #######
#@   #                 ## ####     ## ## ##    #######
#### # ### ########### #   ########## ## #############
#### *  ## ########## *  #            ## #############
#####   ## ##         # ################ #############
########## ## ####### # ################ #####     $.#
########## ## ##   ## # ################     # #######
########## ##   *# ## #          ####### ### *  ######
########## #####   ## ########## ####### ####   ######
########## #####*  ## ########## ####### #############
##########       # ## ########## #######   ###########
################*  ## ########## ######### ###########
#############    #### #########  *  ###### ###########
############# ##      #########   # #####  *  ########
############# ##################### #####   # ########
############# ###################   #########        #
############# ################### ################## #
############# ################### ###      ##      # #
############# ################### ### #  # ## #  # # #
############# ##############      ###  * * ## * *  # #
############# ############## #### #### ## #### ## ## #
############# ############## ####      ## #### ## ## #
############# ############## ############ #### #     #
############# ############## ####      ## #### # #####
############# ############   #### #### ## #### # #####
############# ############ ###### ### * *  * *  * ####
############# ############ ###### ### #   #   # # ####
############# ###########  *  ### ###    ## #   # ####
############# ###########   # ###   ####    ##### ####
############# ############### ##### ############# ####
############# ############### ####              # ####
############# ############### #### ############ *  ###
############# ############         #############   ###
############# ############ #######*###################
#############            # #######  ##################
######################## *  ####### ##################
#########################   ####  *  #################
################################ #   #################
################################ #####################
################################ #####################
######################################################


