#################
#####   #########
#####$  #########
#####  $#########
###  $  $ #######
### # ### #######
#   # ### ##  ..#
# $  $      @ ..#
##### #### #  ..#
#####      ######
#################

####################
#     ###         @#
# ### ### ######## #
# ##  * * ######## #
#$##     ##     ## #
#.###### ## ##  ## #
####### * *  #  ## #
####### #  # #  ## #
#######      #  ## #
##############  ## #
##############     #
####################
